{
	"name": "Level 1",
	"width" : 9,
	"height" : 13,
	"data" : [
	
		[1, 1, 0, 1, 0, 0, 0, 1, 1],
		[1, 0, 0, 0, 0, 0, 0, 0, 1],
		[0, 0, 1, 0, 0, 0, 0, 0, 0],
		[0, 0, 0, 0, 1, 0, 0, 0, 0],
		[0, 0, 0, 1, 2, 1, 0, 0, 0],
		[1, 0, 0, 0, 0, 0, 0, 0, 0],
		[0, 1, 0, 0, 0, 0, 0, 0, 0],
		[0, 0, 0, 0, 1, 0, 0, 0, 0],
		[0, 0, 0, 0, 0, 0, 0, 3, 0],
		[0, 0, 0, 0, 0, 0, 0, 0, 0],
		[0, 0, 0, 0, 0, 0, 0, 0, 0],
		[1, 0, 0, 0, 0, 0, 0, 0, 1],
		[1, 1, 0, 4, 5, 6, 7, 1, 1]
	]
}
