{
	"name": "Level 1",
	"width" : 9,
	"height" : 13,
	"data" : [
	
		[1, 1, 0, 1, 0, 0, 0, 1, 1],
		[1, 0, 0, 0, 0, 0, 0, 0, 5],
		[0, 0, 1, 0, 0, 0, 0, 0, 0],
		[0, 0, 0, 0, 1, 4, 5, 0, 0],
		[0, 0, 0, 1, 2, 0, 0, 0, 0],
		[1, 0, 0, 0, 0, 0, 0, 5, 0],
		[1, 1, 0, 0, 0, 6, 0, 0, 0],
		[4, 0, 0, 0, 1, 0, 0, 0, 0],
		[0, 0, 0, 7, 0, 0, 0, 3, 0],
		[0, 0, 0, 0, 0, 0, 0, 0, 0],
		[7, 0, 5, 0, 0, 0, 0, 0, 0],
		[1, 0, 0, 0, 0, 0, 0, 0, 1],
		[1, 1, 0, 0, 0, 0, 6, 1, 1]
	],

	"slopedata" : [
	
		[2, 4, 0, 0, 0, 0, 0, 0, 5],
		[0, 0, 4, 0, 0, 0, 0, 5, 0],
		[0, 0, 0, 4, 0, 0, 5, 0, 0],
		[0, 0, 0, 0, 4, 5, 0, 0, 0],
		[0, 0, 0, 0, 0, 0, 0, 0, 0],
		[0, 0, 0, 0, 0, 0, 0, 0, 0],
		[0, 0, 0, 0, 0, 0, 0, 0, 0],
		[0, 0, 0, 0, 0, 0, 0, 0, 0],
		[0, 0, 0, 0, 7, 0, 0, 0, 0],
		[0, 0, 0, 7, 0, 6, 0, 0, 0],
		[0, 0, 7, 0, 0, 0, 6, 0, 0],
		[0, 7, 0, 0, 0, 0, 0, 6, 0],
		[7, 0, 0, 0, 0, 0, 0, 0, 6]
	]
}
